able - способный
about - об, о
above - ниже
accept	- принимать
across - через
act - действовать
actually - на самом деле
add - добавлять
admit - признавать
afraid - испуганный, бояться
after - после
afternoon - полдень
again - снова, опять
against	- против
age - возраст
ago - назад
agree - соглашаться
ah - ах
ahead - впереди, предстоящий
air - воздух
all - всё
allow - позволять
almost	- практически, почти
alone - один, одинокий
along - вдоль
already - уже
alright - хорошо
also - так же, тоже
although - хотя
always	- всегда
am - быть, являться
amaze - удивлять
and - и
anger - злость
angry - злой
animal	- животное
annoy - раздражать
another - другой
answer - ответ
any - любой
anymore - больше
anyone - любой, всякий
anything - что-либо
anyway - все равно
apartment - квартира
apparently - видимо
appear - появляться
approach - подход
are - быть, являться
area - зона
aren't - не является
arm - рука
around - вокруг
arrive - приезжать
as - как
ask - спрашивать, вопрос
asleep	- спящий
ass - задница
attack - атаковать
attempt - попытка
attention - внимание
aunt - тетя
avoid - избегать
away - прочь
baby - детка
back - назад, спина
bad - плохой
bag - сумка
ball - шар, мяч
band - группа
bar - бар
barely - едва
bathroom - ванная
be - быть
beat - бить
beautiful - красивый
became - стал
because - потому что
become - стать
bed - кровать
bedroom - спальня
been - был
before - до
began - начал
begin - начинать
behind	- позади
believe - верить
bell - колокол
beside	- рядом
besides - кроме
best - лучший
better - лучше
between - между
big - больше
bit - кусочек
bite - кусать
black - черный
blink - мигать
block - блокировать
blonde	- блондин
blood - кровь
blue - синий
blush - краснеть
body - тело
book - книга
bore - бурить
both - оба
bother	- беспокоить
bottle - бутылка
bottom - нижний
box - коробка
boy - мальчик
boyfriend - парень
brain - мозг
break - ломать
breakfast - завтрак
breath -  дыхание
breathe - дышать
bright - яркий
bring - приносить
broke - сломать
broken	- сломанный
brother - брат
brought - принес
brown - коричневый
brush - щетка
build - строить
burn - гореть
burst - лопаться
bus - автобус
business - бизнес
busy - занят
but - но
buy - покупать
call - звать, звонить
calm - спокойный
came - пришел
can - можешь
can't - не можешь
car - машина
card - карта
care - забота
carefully - осторожно
carry - нести
case - случай
cat - кот, кошка
catch - ловить
caught - пойманный
cause - причина
cell - продавать
chair - стул
chance - шанс
change - изменять
chase - гнаться
check - проверять
cheek - щека
chest - грудь, сундук
child - ребенок
children - дети
chuckle - посмеиваться
city - город
class - класс
clean - чистый
clear - ясный
climb - взбираться
close - закрывать
clothes - одежда
coffee - кофе
cold - холодный
college - колледж
color - цвет
come - приходить
comment - комментарий
complete - полный
completely - полностью
computer - компьютер
concern - беспокойство
confuse - путать
consider - учитывать
continue - продолжать
control	- контроль, контролировать
conversation - беседа
cool - прохладный
corner - угол
couch - диван
could - мог
couldn't - не мог
counter - прилавок
couple - пара
course - курс
cover - покров
crack - трескаться
crazy - сумасшедший
cross - крест
crowd - толпа
cry - кричать, плакать
cup - чашка
cut - резать
cute - милый
dad - папа
damn - проклятие
dance - танцевать
dark - тьма, тёмный
date - дата, свидание
daughter - дочь
day - день
dead - мертвый
deal - иметь дело
dear - дорогой
death - смерть
decide - решать
deep - глубокий
definitely - определенно
desk - рабочий стол
did - делал
didn't - не делал
die - умереть
different - другой
dinner - ужин
direction - направление
disappear - пропадать
do - делать
doctor - доктор
does - делает
doesn't	 - не делает
dog - собака
don't - не делать
done - сделанный
door - дверь
doubt - сомневаться
down - вниз
drag - тащить
draw - рисовать
dream - мечтать, сниться
dress - платье
drink - пить
drive - водить
drop - уронить
drove - водил
dry - сухой
during - во время, в течении
each - каждый
ear - ухо
early - рано
easily - легко
easy - легкий
eat - есть
edge - край
either - или
else - иначе
empty - пустой
end - конец
enjoy - наслаждаться
enough - достаточно
enter - входить
entire - весь
escape - побег
especially - особенно
even - даже
evening - вечер
eventually - в конце концов
ever - всегда
every - каждый
everyone - каждый
everything - всё
exactly - точно, именно
except	- кроме, исключая
excite - возбуждать
exclaim - восклицать
excuse - извинения
expect	- ожидать
explain - объяснять
expression - выражение
eye - глаз
eyebrow - бровь
face - лицо
fact - факт
fall - падать, осень
family - семья
far - далеко
fast - быстро
father - отец
fault - вина
favorite - любимый
fear - страх
feel - чувствовать
feet - ноги
fell - упал
felt - чувствовал
few - немного
field - поле
fight - драка, борьба
figure - фигура
fill - наполнять
finally - наконец
find - находить
fine - отлично
finger - палец
finish - заканчивать
fire - огонь
first - первый
fit - подходить, соответствовать
five - пять
fix - исправлять
flash - вспышка
flip - подбросить
floor - пол
fly - муха, летать
focus - фокус
follow - следовать
food - еда
foot - нога
for - для
force - сила, войска
forget - забывать
form - форма
forward - вперед
found - нашел
four - четыре
free - бесплатный, свободный
friend - друг
from - из
front - передний
frown - хмуриться
full - полный
fun - веселье
funny - забавный
further	- дальше
game - игра
gasp - задыхаться
gave - дал
gaze - взор, посмотреть
gently - нежно
get - получать
giggle - хихикать
girl - девочка
girlfriend - девушка
give - давать
given - данный
glad - радостный
glance - бегло глянуть
glare - яркий свет
glass - стакан, стекло
go - идти
God - Бог
gone - ушел
gonna - собираюсь
good - хороший
got - получил
gotten - получил
grab - схватить
great - великий, отличный
green - зелёный
greet - приветствовать
grey - серый
grin - ухмылка
grip - схватить
groan - стон
ground - земля, основание
group - группа
grow - расти
guard - сторожить
guess - предполагать
gun - оружие
guy - парень
had - имел
hadn't - не имел
hair - волосы
half - половина
hall - зал
hallway - коридор
hand - рука
handle - ручка, рукоятка
hang - вешать
happen - происходить
happy - счастливый
hard - тяжелый
has - имеет
hate - ненавидеть
have - иметь
haven't - не иметь
he - он
he'd - он бы
he's - он является
head - голова
hear - слышать
heard - слышал
heart - сердце
heavy - тяжелый
held - держал
hell - ад
hello - здравствуйте
help - помощь
her - её
here - здесь
herself - сама
hey - привет
hi - привет
hide - спрятать
high - высоко
him - его
himself
his - его
hit - удар
hold - держать
home - дом
hope - надежда
horse - лошадь
hospital - больница
hot - горячий
hour - час
house - дом
how - как
however - однако
hug - обнимать
huge - огромный
huh - хах
human - человек
hundred - сто
hung - висела
hurry - торопиться
hurt - повредить
I - я
I'd - я бы
I'll - я буду
I'm - я являюсь
I've - я
ice - лед
idea - идея
if - если
ignore - игнорировать
imagine - представлять
immediately - немедленно
important - важно
in - в
inside - внутри
instead
interest - заинтересован
interrupt - перебить
into - в
is - является
isn't - не является
it - это
it's - это является
its - его
jacket - куртка
jeans - джинсы
jerk - придурок
job - работа
join - присоединять
joke - шутка
jump - прыгать
just - просто
keep - хранить
kept - хранил
key - ключ
kick - пинать
kid - ребенок
kill - убить
kind - добрый
kiss - поцелуй
kitchen - кухня
knee - колено
knew - знал
knock - стучать
know - знать
known - известен
lady - леди
land - земля
large - большой
last - последний
late - поздно
laugh - смех
lay - класть
lead - вести
lean - наклонять
learn - изучать
least - наименее
leave - оставлять
led - вел
left - покинул, лево
leg - нога
less - меньше
let - позволить
letter - письмо
lie - ложь, лгать
life - жизнь
lift - поднимать
light - свет, светить
like - нравится
line - линия
lip - губа
listen - слушать
little - маленький, мало
live - жить
lock - заблокировать
locker - шкафчик
long - длинный, долгий
look - смотреть
lose - проиграть, потерять
lost - потерянный
lot - большой, много
loud - громкий
love - любить
low - низкий
lunch - обед
mad - безумный
made - сделать
make - сделанный
man - мужчина, человек
manage - суметь, управлять
many - много (исч.)
mark - отметка
marry - выйти замуж, жениться
match - соответствовать, матч
matter - иметь значение
may - может
maybe	- может быть
me - я, мне
mean - иметь ввиду
meant - имел ввиду
meet - знакомиться, видеться
memory - память
men - мужчины
mention - упоминать
met - знакомился, виделся
middle - средний
might - мощь
mind - разум
mine - мое, шахта
minute - минута
mirror - зеркало
miss - скучать
mom - мама
moment - момент
money - деньги
month - месяц
mood - настроение
more - больше
morning - утро
most - большинство
mother	- мать
mouth - рот
move - двигаться
movie - фильм
Mr. - мистер
Mrs. - миссис
much - много
mum - мама
mumble - бормотать
music - музыка
must - должен
mutter - бормотать
my - мой
myself	- мне, свой
name - имя
near - близко, рядом
nearly - около
neck - шея
need - нуждаться
nervous - нервный
never - никогда
new - новый
next - следующий
nice - отлично
night - ночь
no - нет
nod - кивок
noise - шум
none - ничто, никто
normal	- нормально
nose - нос
not - нет
note - примечание
nothing - ничего
notice - уведомлять
now - сейчас
number - номер
obviously - очевидно
off - выключить
offer - предложение
office - офис
often - часто
oh - ох
okay - хорошо
old - старый
on - включить
once - один раз, однажды
one - один
only - только
onto - на
open - открыть
or - или
order - заказ, порядок
other - другие
our - наш
out - вне
outside - снаружи
over - над
own - владеть
pack - пакет
pain - боль
paint - краска
pair - пара
pants - брюки
paper - бумага
parents - родители
park - парк
part - часть
party - вечеринка
pass - проходить
past - прошлое
pause - пауза
pay - платить
people - люди
perfect - отлично
perhaps - возможно
person - человек
phone - телефон
pick - выбирать
picture - картинка, картина
piece - кусок
pink - розовый
piss - моча
place - место
plan - план
play - играть
please - пожалуйста
pocket - карман
point - точка
police - полиция
pop - хлопнуть
position - позиция
possible - возможно
power - сила, мощь
practically - практически
present - наст. время, подарок
press - нажимать
pretend - притворяться
pretty - симпатичный
probably - вероятно
problem - проблема
promise - обещать
pull - тянуть
punch - ударить кулаком
push - толкать
put - положить
question - вопрос
quick - быстрый
quickly	- быстро
quiet - тихий
quietly - тихо
quite - довольно
race - раса
rain - дождь
raise - поднимать
ran - бежал
rang - звонил
rather - скорее
reach - достигать
read - читать
ready - готов
real - реально
realize - осознавать
really - действительно
reason - причина
recognize - распознавать
red - красный
relationship - отношение
relax - расслабиться
remain	- оставаться
remember - запомнить
remind	- напоминать
repeat - повторять
reply - отвечать
respond - отвечать
rest - остальные, отдых
return - возвращать
ride - ездить верхом
right - верно, право
ring - кольцо
road - дорого
rock - камень
roll - рулон
room - комната
rose - роза
round - круглый
rub - натирать
run - бежать
rush - торопиться
sad - грустный
safe - безопасный
said - сказал
same - такой же
sat - суббота
save - сохранить
saw - пила
say - сказать
scare - напугать
school	- школа
scream - крик
search - поиск
seat - сиденье
second	 - секунда
see - видеть
seem - кажется
seen - видимый
self - себя
send - отправить
sense - смысл
sent - отправил
serious	 - серьезный
seriously - серьезно
set - набор
settle - решить
seven - семь
several - несколько
shadow - тень
shake - змея
share - делиться
she - она
she'd - она бы
she's - она является
shift - сдвиг
shirt - рубашка
shit - дерьмо
shock - шок
shoe - обувь
shook - встряхнул
shop - магазин
short - короткий
shot - выстрелил
should - должен
shoulder - плечо
shouldn't - не должен
shout - кричать
shove - пихать
show - показывать
shower	 - дуг
shrug - пожимание плечами
shut - закрыть
sick - больной
side - сторона
sigh - вздох
sight - взгляд
sign - подписать
silence - безмолвие, тишина
silent - тихий
simply - просто
since - с
single - одинокий
sir - сэр
sister - сестра
sit - сидеть
situation - ситуация
six - шесть
skin - кожа
sky - небо
slam - хлопать
sleep - спать
slightly - немного
slip - соскальзывать
slow - медленный
slowly - медленно
small - маленький
smell - запах
smile - улыбка
smirk - ухмыляться
smoke - курить, дым
snap - щелчок
so - так
soft - мягкий
softly - мягко
some - некоторый
somehow - как-то
someone - кто-то
something - что-нибудь
sometimes - иногда
somewhere - где-то
son - сын
song - песня
soon - скоро
sorry - извини
sort - сортировать
sound - звук
space - пространство, космос
speak - говорить
spend - проводить
spent - потраченный
spoke - говорил
spot - место
stair - лестница
stand - стоять
star - звезда
stare - глазеть
start - начинать
state - состояние
stay - оставаться
step - шаг
stick - палка
still - все еще
stomach - желудок
stood - стоял
stop - остановиться
store - магазин
story - история
straight - прямой
strange - странный
street - улица
strong - сильный
struggle - борьба
stuck - застрявший
student - студент
study - учиться
stuff - вещи, материал
stupid - тупой
such - такой
suck - сосать
sudden - внезапный
suddenly - внезапно
suggest - предлагать
summer - лето
sun - солнце
suppose - предполагать
sure - уверен
surprise - удивлять
surround - окружать
sweet - сладкий
table - стол
take - брать
taken - взятый
talk - разговаривать
tall - высокий
teacher - учитель
team - команда
tear - рвать, слеза
teeth - зубы
tell - говорить
ten - десять
than - чем
thank - спасибо
that - тот
that's - это
their - их
them - им
themselves - сами себя
then - тогда
there - там
there's	- есть
these - эти
they - они
they'd - они бы
they're - они являются
thick - толстый
thing - вещь
think - думать
third - третий
this - этот
those - те
though	- хотя
thought - мысль
three - три
threw - бросил
throat - горло
through - через
throw - бросать
tie - галстук
tight - тугой
time - время
tiny - крохотный
tire - шина
today - сегодня
together - вместе
told - сказал
tomorrow - завтра
tone - тон
tongue	- язык
tonight	- сегодня вечером, сегодня ночью
too - тоже, слишком
took - брал
top - сверху
totally - полностью
touch - трогать
toward - по направлению
town - городок
track - отслеживать
trail - тащить
train - поезд
tree - дерево
trip - путешествие
trouble - беда
TRUE - истинный
trust - доверять
truth - правда
try - пытаться
turn - повернуть
TV - телевизор
twenty - двадцать
two - два
type - тип
uncle - дядя
under - под
understand - понимать
until - до, не раньше
up - вверх
upon - на
us - нам, нас
use - использовать
usual - обычный
usually	- обычно
very - очень
visit - посещать
voice - голос
wait - ждать
wake - будить
walk - ходить
wall - стена
want - хотеть
warm - теплый
warn - предупреждать
was - был
wasn't - не был
watch - смотреть
water - вода
wave - волна
way - путь, дорога
we - мы
we'll - мы будем
we're - мы являемся
we've - у нас есть
wear - носить
week - неделя
weird - странно
well - хорошо
went - пошел
were - были
weren't - не были
wet - влажный
what - что
what's - что такое
whatever - что бы ни
when - когда
where - где
whether - ли
which - который
while - пока
whisper - шепот
white - белый
who - кто
whole - весь
why - почему
wide - широкий
wife - жена
will - будет
wind - ветер
window - окно
wipe - вытирать
wish - желать
with - с
within - в пределах
without - без
woke - проснулся
woman - женщина
women - женщины
won't - не будет
wonder - удивляться
wood - древесина
word - слово
wore - носил
work - работа
world - мир
worry - беспокоить
worse - хуже
would - бы
wouldn't - бы не
wow - вау
wrap - сворачивать, обертка
write - писать
wrong - неправильный
yeah - ага
year - год
yell - кричать
yes - да
yet - пока
you - ты
you'd - ты бы
you'll - ты будешь
you're - ты являешься
you've	- у тебя есть
young - младший
your - твой
yourself - твой, тебе
